.........#...............
.........#...............
.........#...............
.........#...............
.........#...............
.........#...............
################...######
.........................
.........................
.........................
.........................
.........................
.........................
####...##################
.........#...............
.........#...............
.........#...............
.........#...............
.........#...............
.........#...............