........#................
........#................
........#................
........#................
........#................
........#................
.........................
.........................
.........................
........#................
........#................
#########################
........#................
........#................
........#................
.........................
.........................
.........................
........#................
........#................